NO ./frames/wall.xpm
SO ./frames/cobblestone.xpm
WE ./frames/coal.xpm
EA ./frames/greystone.xpm



F 123,100,123
C 225,123,123

1111111111111111111111111
10000000000000000000001D1
1000000000000000000000001
1000000000000000000000001
1000000000000000000000001
1000001111110111111000001
100000111111D111111000001
1000001111110111111000001
1000001110000000111000001
1000001110000000111000001
1000001110000000111000001
1000001110000000111000001
1000000D000000000D0000001
1000001110000000111000001
1000001110000000111000001
1000001110000000111000001
1000001110000000111000001
1000001111110111111000001
100000111111D111111000001
1000001111110111111000001
1000000000000000000000001
1000000000000000000000001
1000000000000000000000001
10000000000N0000000000001
1111111111111111111111111