NO ./textures/wall.xpm
SO ./textures/cobblestone.xpm
WE ./textures/coal.xpm
EA ./textures/greystone.xpm



F 220,100,0
C 0,0,1


        1111111111111111111111111
        1000000000110000000000001
        1011000001110000000000001
        1001000000000000000000001
111111111011000001110000000000001
100000000011000001110111111111111
11110111111111011100000010001
11110111111111011101010010001
11000000110101011100000010011
100000000010011110000001010111111
1000000001001100001101010010001
11000001110101111111011000N011111
11110111 1110101 101111010001
11111111 1111111 111111111111
