NO ./textures/eagle.xpm
SO ./textures/greystone.xpm
WE ./textures/wall.xpm
EA ./textures/greystone.xpm

F 123,100,123
C 225,123,123



11111111111111111111111111111
10000000000000000000000000001
10000000000000000000000000001
10000000000000000000000000001
10000000000000000000000000001
10000000000000000000000000001
10000000001100001100000000001
10000000010000000010000000001
10000000010000000010000000001
10000000010000000010000000001
10000000010000000010000000001
10000000001100001100000000001
10000000000000000000000000001
10000000000000000000000000001
10000000000000000000000000001
10000000000000000000000000001
100000000000N0000000000000001
10000000000000000000000000001
11111111111111111111111111111


