NO ./textures/eagle.xpm
SO ./textures/greystone.xpm
WE ./textures/wall.xpm
EA ./textures/greystone.xpm

F 139,90,43
C 243,231,231



11111111111111111111111111111
10000000000000000000000000001
10000000000000000000000000001
10000000000000000000000000001
10000000000000000000000000001
10000000000000000000000000001
10000000001100001100000000001
10000000010000000010000000001
10000000010000000010000000001
10000000010000000010000000001
10000000010000000010000000001
10000000001100001100000000001
10000000000000000000000000001
10000000000001000000000000001
10000000000010100000000000001
10000000000001000000000000001
100000000000N0000000000000001
10000000000000000000000000001
11111111111111111111111111111


