NO ./textures/1.xpm
SO ./textures/2.xpm
WE ./textures/3.xpm
EA ./textures/4.xpm

F 139,90,43
C 243,231,231

1111111111
1000000011
1000000011
1000000011
1000000001
1001100001
10010N0001

1000000001
1000000001
1000000001
1111111111
