NO ./textures/wall.xpm
SO ./textures/cobblestone.xpm
WE ./textures/coal.xpm
EA ./textures/greystone.xpm



F 123,100,123
C 225,123,123

111111111111111111111111
100000000000000000000001
100000000000000000000001
10000001111D111110000001
100000010000000010000001
100000010000000010000001
100000010000000010000001
100000010000000010000001
100000010000000010000001
1000000D00000000D0000001
100000010000000010000001
100000010000000010000001
100000010000000010000001
10000001111D111110000001
100000000000000000000001
100000000000000000000001
100000000000000000000001
100000000000000000000001
10000000000N000000000001
111111111111111111111111