NO ./frames/coal.xpm
SO ./textures/2.xpm
WE ./textures/3.xpm
EA ./textures/4.xpm



F 205,133,0
C 243,231,231

1111111111111111111111111
1000000000000000000000001
1000000000000000000000001
100000011111D111110000001
1000000100000000010000001
1000000100000000010000001
1000000100000000010000001
1000000100000000010000001
1000000100000000010000001
1000000D000000000D0000001
1000000100000000010000001
1000000100000000010000001
1000000100000000010000001
1000000100000000010000001
100000011111D111110000001
1000000000000000000000001
1000000000000000000000001
1000000000000000000000001
1000000000000000000000001
10000000000N0000000000001
1111111111111111111111111