NO ./textures/1.xpm
SO ./textures/2.xpm
WE ./textures/3.xpm
EA ./textures/4.xpm

F 139,90,43
C 243,231,231


 11111111
10010N1001
1000010001
1000010001
10001 1001
1000010001
 11111111